能力	Ability	\N	\N
抽象	Abstract	\N	\N
住宿	Accommodation	\N	\N
行为	Actions	\N	\N
管理	Administration	\N	\N
附类	Affixes	\N	\N
农业	Agriculture	\N	\N
人类学	Anthropology	\N	\N
建筑学	Architecture	\N	\N
艺术	Art	\N	\N
天文	Astronomy	\N	\N
试行	Attempt	\N	\N
航空	Aviation	\N	\N
美丽	Beauty	\N	\N
生物学	Biology	\N	\N
植物学	Botany	\N	\N
佛教	Buddhism	\N	\N
书法	Calligraphy	\N	\N
种类	Category	\N	\N
特点	Characteristic	\N	\N
化学	Chemistry	\N	\N
变化	Change	\N	\N
慈善会	Charity	\N	\N
中医	Chinese Medicine	\N	\N
基督教	Christianity	\N	\N
土木	Civil Engineering	\N	\N
古文	Classical Chinese	\N	\N
气候	Climate	\N	\N
服装	Clothing	\N	\N
口语	Colloquial	\N	\N
颜色	Color	\N	\N
商务	Commerce	\N	\N
通讯	Communications	\N	\N
比较	Comparison	\N	\N
状况	Condition	\N	\N
冲突	Conflict	\N	\N
容器	Container	\N	\N
化妆品	Cosmetic	\N	\N
文化	Culture	\N	\N
习俗	Customs	\N	\N
跳舞	Dancing	\N	\N
灾难	Disaster	\N	\N
戏剧	Drama	\N	\N
经济	Economics	\N	\N
教育	Education	\N	\N
电器	Electrical Appliances	\N	\N
电	Electricity	\N	\N
电子	Electronics	\N	\N
电气工程	Electrical Engineering	\N	\N
感情	Emotion	\N	\N
能源	Energy	\N	\N
环境	Environment	\N	\N
儿化	Erhua	\N	\N
道德	Ethics	\N	\N
日常生活	Everyday Life	\N	\N
设备	Facilities	\N	\N
家	Family	\N	\N
财会	Finance and Accounting	\N	\N
火	Fire	\N	\N
饮食	Food and Drink	\N	\N
外语	Foreign Language	\N	\N
形态	Form	\N	\N
友谊	Friendship	\N	\N
虚词	Function Words	\N	\N
家具	Furniture	\N	\N
世系	Genealogy	\N	\N
地理	Geography	\N	\N
地质	Geology	\N	\N
政府	Government	\N	\N
语法	Grammar	\N	\N
健康	Health	\N	\N
帮助	Help	\N	\N
历史	History	\N	\N
荣誉	Honor	\N	\N
家庭用品	Household Article	\N	\N
幽默	Humor	\N	\N
打猎	Hunting	\N	\N
卫生	Hygiene	\N	\N
成语	Idiom	\N	\N
工业	Industry	\N	\N
信息	Information	\N	\N
信息技术	Information Technology	\N	\N
叹词	Interjection	\N	\N
配饰	Jewelry	\N	\N
功夫	Kungfu	\N	\N
语言	Language	\N	\N
法律	Law	\N	\N
休闲	Leisure	\N	\N
生活	Life	\N	\N
光纤	Light	\N	\N
语言学	Linguistics	\N	\N
文学	Literature	\N	\N
逻辑	Logic	\N	\N
爱情	Love	\N	\N
运气	Luck	\N	\N
海上	Maritime	\N	\N
实物	Material Object	\N	\N
物料	Materials	\N	\N
数学	Mathematics	\N	\N
测控	Measurement and Control	\N	\N
机械	Mechanical	\N	\N
媒体	Media	\N	\N
医疗	Medicine	\N	\N
冶金	Metallurgy	\N	\N
军事	Military	\N	\N
登山	Mountaineering	\N	\N
移动	Movement	\N	\N
音乐	Music	\N	\N
神话	Mythology	\N	\N
名字	Names	\N	\N
大自然	Nature	\N	\N
观察	Observation	\N	\N
组织	Organization	\N	\N
人	People	\N	\N
哲学	Philosophy	\N	\N
摄影术	Photography	\N	\N
物理	Physics	\N	\N
偏旁	Pianpang	\N	\N
地方	Places	\N	\N
诗	Poetry	\N	\N
政治	Politics	\N	\N
位	Position	\N	\N
身姿	Posture	\N	\N
过程	Process	\N	\N
心理学	Psychology	\N	\N
公安	Public Security	\N	\N
数量	Quantity	\N	\N
部首	Radicals	\N	\N
联系	Relationship	\N	\N
宗教	Religion	\N	\N
重复	Repetition	\N	\N
安全	Safety	\N	\N
科学	Science	\N	\N
规模	Scale	\N	\N
交际	Social Interaction	\N	\N
社会	Society	\N	\N
声	Sound	\N	\N
航天	Space Flight	\N	\N
体育	Sport	\N	\N
文具	Stationery	\N	\N
力气	Strength	\N	\N
老舍茶馆	Teahouse by Lao She	\N	\N
技术	Technology	\N	\N
温度	Temperature	\N	\N
思想	Thought	\N	\N
时间	Time	\N	\N
工具	Tools	\N	\N
旅游	Tourism	\N	\N
玩具	Toys	\N	\N
交通	Transportation	\N	\N
用具	Utensil	\N	\N
暴力	Violence	\N	\N
水	Water	\N	\N
财富	Wealth	\N	\N
武器	Weapons	\N	\N
工作	Work	\N	\N
写作	Writing	\N	\N
书	Written Chinese	\N	\N
动物学	Zoology	\N	\N
